##############################
#............................#
#............................#
#............................#
#............................#
#............................#
#.........#####..............#
#..........######............#
#............####............#
#............................#
#............................#
#............................#
#............................#
#............................#
#........########............#
#......##########............#
#............................#
#............................#
#............................#
##############################