##############################
#..!!!!!!!!!!!!!!!!!!!!!!!!!.#
!!!!.......................!.#
#.......!!!!!!!!!!.....!!!!!.#
#..!!!!!!........!!!!!!!.....#
#..!.........................#
#..!.........................#
#..!......!!!!!!.............#
#..!!.....!....!.............#
#...!.....!....!!!!!!!!!!!!!!#
#...!.....!.................!#
#...!!!!!!!.................!#
#...........................!#
#...........................!#
#...........!!!!!!!!!!......!#
#.!!!!!!!!!!!........!!!!!!!!#
#.!..........................#
#.!!!!!!!!!!!!!!!!!!!!!!!!!!.#
#..........................!.#
##########################.!.#